NO xpms/1p.xpm
SO xpms/2p.xpm
WE xpms/3p.xpm
EA xpms/4p.xpm

C 103,193,202
F 125,130,140

        1111111111111111111111111
        1000000000110000000000001
        1011000001110000000000001
        1001000000000000000000001
1111111110110000011100000000000E1
100000000011000001110111100011111
11110111111111011100000010001
11110111111111011101010010001
11000000110101011100000010001
10000000000000001100000010001
1100000111010101111101110000111
11110111 1110101 101111010001
11111111 1111111 111111111111