NO textures/wood_strips.xpm
SO textures/wood.xpm
WE textures/wood_box.xpm
EA textures/rocks.xpm

C 97, 85, 127
F 90, 90 ,90


      1111111               11111111111111111111
      1000001               10000000000000000001 1111111111
      1000001      1111111111000000000000000000111000000001
      1110111      1000000011000000000000000000000000000001
        101        1000000000000000000000000000111000000W01
1111111100011111  1110111111111111110011111111111 1111111111
1000001100000000110000001          1001
1000000000000000000000001      111100001111
1000001100000000000000001      100000000001
1110111100000000110000001      100000000001
1000001 11111111111111111      100000000001
1000001 10000000000001         100000000001
1000001110000000000001         100000000101
1000000000000000000001         100000000001
1000001110000000000001         100000000001
1000001 10000000000001         100000000001
1000001 11111111111111         100000000001
1000001                        100000000001
1000001                        100000000001
1000001                        100000000001
1000111                        100000000001
1000001                        100000000001
1000001                        100000000001
1000001                        100010000001
1100001                        100000000001
1000001                        100000000001
1000001                        100000000001
1000001                        100000000001
1000001                        100000000001
1000011                        100000000001
1000001                        100000000001
1110001                        100000000001
1000001                        100000000001
1000001                        100000010101
1000001                        100000010101
1000001                        100000100011
1000001                        111111111111
1000001
1000001111111111111111111111111111111111111111111111111111
1000001100000000000100110000000000000110000011000000000001
1000000000000000000000000000000000000000000000000000000001
1000001100000010000000110000000000000110000000000011000001
1111111111111111111111111111111111111111111111111111111111