NO textures/wood_strips.xpm
SO textures/wood.xpm
WE textures/wood_box.xpm
EA textures/rocks.xpm
DR textures/door.xpm

C 155,154,100
F 47,70,65

        1111111111111111111111111
        1000000000110000000000001
        1D11000001110000000000001
        1001E00000D00000000000001
111111111011000001110000000000001
10000000001100000111011111D111111
11110111111111D11100000010001
1111D111111111011101010010001
11000000110101011100000010001
10000000000000001100000010001
10000000000000001101010010001
1100000111010101111101111000111
11110111 1110101 101111010001
11111111 1111111 111111111111